1111111111111111111111
100000000000C1000C10E1
1010100111101101111011
10101111C1001000100001
1P10000001100000000001
1111111111111111111111